111111111111111111111
111P11100000100000001
100011C01110100000001
101111111110100000001
100000000000000000001
1C0000000000000000001
100000000000000000001
1C1000010000100100001
111111111000000000001
100000111011010101011
100110111011010101011
1E0010000011C1C1C1C11
111111111111111111111
